5 10
|--------|
|...|..-.|
|..-|.@P.|
|.G....-.|
|--------|